TGCGCCACCTGGGGGGACGAGCAGTACTTC	CATWGDEQYF	TRBV10-2	TRBJ2-7
TGTGCCAGCTCACCTACGAATTCAGGATCAAACTATGGCTACACCTTC	CASSPTNSGSNYGYTF	TRBV18	TRBJ1-2
TGCGGGCCCGTAATGAACACTGAAGCTTTCTTT	CGPVMNTEAFF	TRBV10-2	TRBJ1-1
TGTGCCAGCAGTGAAGCGCGTCCAGCCAGGATGTATGGCTACACCTTC	CASSEARPARMYGYTF	TRBV6-1	TRBJ1-2
TGTGCCAGCAGTAGTGGGACAGGACCGGATCAGCCCCAGCATTTT	CASSSGTGPDQPQHF	TRBV6-3	TRBJ1-5
TGTGCCAGCAACCTAGCGGGGAAGAACACCGGGGAGCTGTTTTTT	CASNLAGKNTGELFF	TRBV6-2	TRBJ2-2
TGTGCCAGCAGCCAACCGGGGGGGTCAGGTAACTATGGCTACACCTTC	CASSQPGGSGNYGYTF	TRBV4-2	TRBJ1-2
TGCGCCAGCAGCCGCGGCCTCAGGGAAGAGACCCAGTACTTC	CASSRGLREETQYF	TRBV5-1	TRBJ2-5
TGTGCCAGCAGCCAAGTCTCACGACAGGACAGCTCCTACGAGCAGTACTTC	CASSQVSRQDSSYEQYF	TRBV4-2	TRBJ2-7
TGTGCCAGCAGGCCGGGACAGGGGGCGCCGGGGTGGGAGGATAACTATGGCTACACCTTC	CASRPGQGAPGWEDNYGYTF	TRBV28	TRBJ1-2
TGTGCCAGCAGCCGTCGTTTGCGGGACTTGAAAAACATTCAGTACTTC	CASSRRLRDLKNIQYF	TRBV14	TRBJ2-4
TGTGCCAGCAGCCACCCGAGGCAAGAGACCCAGTACTTC	CASSHPRQETQYF	TRBV7-9	TRBJ2-5
TGTGCCAGCAGCCTAGCTGGGAACTACGAGCAGTACTTC	CASSLAGNYEQYF	TRBV13	TRBJ2-7
TGTGCCAGCAGCTGGAGCCCCATCGGGATCGAGCAGTACTTC	CASSWSPIGIEQYF	TRBV7-2	TRBJ2-7
TGTGCCAGCAGCAGAGTCAGTACAGGGAAGTCGTCCGGCTACACCTTC	CASSRVSTGKSSGYTF	TRBV13	TRBJ1-2
TGTGCCAGCATTTGGGTGGAAAAACTGTTTTTT	CASIWVEKLFF	TRBV7-9	TRBJ1-4
TGTGCTAGTGGTTGCCGAGGGACTAGCGGGGGGGCCTCCTTGGATGAGCAGTTCTTC	CASGCRGTSGGASLDEQFF	TRBV12-5	TRBJ2-1
TGTGCCAGCAGCGTTGGTAGCCAGGGGTACGAGCAGTACTTC	CASSVGSQGYEQYF	TRBV7-3	TRBJ2-7
TGTGCCGTTGGGGCTCCGTCCAGCAATCAGCCCCAGCATTTT	CAVGAPSSNQPQHF	TRBV6-1	TRBJ1-5
TGTGCCAGAGTCCTAGAGACCCAGTACTTC	CARVLETQYF	TRBV19	TRBJ2-5
TGTGCTAGCAGCTTAGCGCCGGGTGTCGGTGCAGACAATGAGCAGTTCTTC	CASSLAPGVGADNEQFF	TRBV7-7	TRBJ2-1
TGTGCCAGCAGTGGGGGGTATGGCTACACCTTC	CASSGGYGYTF	TRBV2	TRBJ1-2
TGTGCCAGCCAGGGGGACAATCAGCCCCAGCATTTT	CASQGDNQPQHF	TRBV7-3	TRBJ1-5
TGTGCCACCACCAAGATATGGCCTAATGAAAAACTGTTTTTT	CATTKIWPNEKLFF	TRBV24-1	TRBJ1-4
TGTGCCAGCAGTGGAGCTCTGTTACACCTACTGGGCCCGCTAATTAGCTCCTACGAGCAGTACTTC	CASSGALLHLLGPLISSYEQYF	TRBV27	TRBJ2-7
TGTGCCACCAACCCTGGGACAGGGTATCAGCCCCAGCATTTT	CATNPGTGYQPQHF	TRBV24-1	TRBJ1-5
TGTGCCAGCAGTCAATTGATGGGACAGGAAGACCCAACTAATGAAAAACTGTTTTTT	CASSQLMGQEDPTNEKLFF	TRBV6-5	TRBJ1-4
TGTGCCACCAGTGATTTGGGTGTTAGGAGGGGGGCCCTTATTGCAACTAATGAAAAACTGTTTTTT	CATSDLGVRRGALIATNEKLFF	TRBV24-1	TRBJ1-4
TGTGCCAGCAGCGTCGACACTAGCGGGAGGGACTCTAATGAAAAACTGTTTTTT	CASSVDTSGRDSNEKLFF	TRBV9	TRBJ1-4
TGTGCCAGCAGCGGAGACAGGGATAGAAGCTATGGCTACACCTTC	CASSGDRDRSYGYTF	TRBV9	TRBJ1-2
TGTGCCACCAGTGAACCGCCAAACGAGCAGTACTTC	CATSEPPNEQYF	TRBV24-1	TRBJ2-7
TGTGCCAGCGATAAAACGAGCTCCTACGAGCAGTACTTC	CASDKTSSYEQYF	TRBV11-3	TRBJ2-7
TGTGCCAGCAGTTCAAGTACCCCGACTGTTCTCACCGGGGAGCTGTTTTTT	CASSSSTPTVLTGELFF	TRBV5-6	TRBJ2-2
TGTGCCATCAGTGCGGGGACAGGGGGAGTTAATGAAAAACTGTTTTTT	CAISAGTGGVNEKLFF	TRBV10-3	TRBJ1-4
TGTGCCACCAGCAGAAAATTCTGGACTAGCGGGGAGGGGCGTGAGCAGTTCTTC	CATSRKFWTSGEGREQFF	TRBV15	TRBJ2-1
TGTGCCACACGGCGGGGCTATGGCTACACCTTC	CATRRGYGYTF	TRBV24-1	TRBJ1-2
TGTGCCAGCAGCACCGGGCCTAATCAGCCCCAGCATTTT	CASSTGPNQPQHF	TRBV7-3	TRBJ1-5
TGTGCCAGCAGTAATTCGGGGGACACCGGGGAGCTGTTTTTT	CASSNSGDTGELFF	TRBV6-5	TRBJ2-2
TGTGCCAGCAGCCAGACAGGGGGCGGAACTGAAGCTTTCTTT	CASSQTGGGTEAFF	TRBV7-3	TRBJ1-1
TGTGCCAGCAGCTCTAGCGGAGCGAACACCGGGGAGCTGTTTTTT	CASSSSGANTGELFF	TRBV11-3	TRBJ2-2
TGTGCCAGCAGCTCGGCGACGGGACGGAAAGAAGATAATGGCTACACCTTC	CASSSATGRKEDNGYTF	TRBV5-5	TRBJ1-2
TGTGCCACCAGGGGTGCGAAACGGATTGACGAGCAGTACTTC	CATRGAKRIDEQYF	TRBV24-1	TRBJ2-7
TGTGCCAGCAGCACAGGAGACAGCCGCTCCTACGAGCAGTACTTC	CASSTGDSRSYEQYF	TRBV7-3	TRBJ2-7
TGTGCCAGCAGCCCCAACGGACAGGGGCCGTACGAGCAGTACTTC	CASSPNGQGPYEQYF	TRBV7-6	TRBJ2-7
TGTGCCCCGCCGGGACTAGCGGGGCCATCAGATACGCAGTATTTT	CAPPGLAGPSDTQYF	TRBV6-5	TRBJ2-3
TGCGCCAGCAGTGAGTGCGAAGGAACCGGGACTAGCGGATCCTACAATGAGCAGTTCTTC	CASSECEGTGTSGSYNEQFF	TRBV10-1	TRBJ2-1
TGTGCCACCAGCAGAGATCCAGGGGGCGGTTGTACTGAAGCTTTCTTT	CATSRDPGGGCTEAFF	TRBV15	TRBJ1-1
TGCGCCAGCAGCTTACGGGGACAGGGGCTTTTAAGGGGCAATCAGCCCCAGCATTTT	CASSLRGQGLLRGNQPQHF	TRBV5-1	TRBJ1-5
TGTGCCAGCAGTCGGCTAGGGCCGGCCAAACAGCCCCAGCATTTT	CASSRLGPAKQPQHF	TRBV12-3	TRBJ1-5
TGTGCCAGCAGCGGGGGGACTAGCGGGGACTCCTACGAGCAGTACTTC	CASSGGTSGDSYEQYF	TRBV5-6	TRBJ2-7
TGTGCCAGCAGCTTTACAAGGACAGGGAATAGCACTGAAGCTTTCTTT	CASSFTRTGNSTEAFF	TRBV13	TRBJ1-1
TGCGCCAGCAGCTTCAGTTGTCTCCGGGGCGAGAGCTCCTACAATGAGCAGTTCTTC	CASSFSCLRGESSYNEQFF	TRBV5-1	TRBJ2-1
TGTGCCAGCAGCTTAGGGACATTGGGGGTCTATGGCTACACCTTC	CASSLGTLGVYGYTF	TRBV11-2	TRBJ1-2
TGTGCCAGCACACCCGAGGGAACTAATGAAAAACTGTTTTTT	CASTPEGTNEKLFF	TRBV27	TRBJ1-4
TGTGCCAGCAGGGGGCTTTTCCCTCAGCCCCAGCATTTT	CASRGLFPQPQHF	TRBV6-3	TRBJ1-5
TGTGCCAGCAGCGCCCGGTTTTACAATGAGCAGTTCTTC	CASSARFYNEQFF	TRBV27	TRBJ2-1
TGTGCCAGCAGCCAAGAGACTAGGGCTCACGAGCAGTACTTC	CASSQETRAHEQYF	TRBV3-1	TRBJ2-7
TGCAGTGCTAGCGGCCTAGCGGGGAGAACAATAAGCTCCTACAATGAGCAGTTCTTC	CSASGLAGRTISSYNEQFF	TRBV20-1	TRBJ2-1
TGTGCCATCATACGAACCCAGAGGGTAGCTGTAAGGAGCTCCTATAATTCACCCCTCCACTTT	CAIIRTQRVAVRSSYNSPLHF	TRBV10-3	TRBJ1-6
TGTGCCAGCAGTCCCCTCAGGCCGGGTCCTACCTACGAGCAGTACTTC	CASSPLRPGPTYEQYF	TRBV6-1	TRBJ2-7
TGTGCCAGCAGCTTAGAAGAGGGAATTACAGTTTCTTATGAGAGGTGGGACAGCACTGAAGCTTTCTTT	CASSLEEGITVSYERWDSTEAFF	TRBV13	TRBJ1-1
TGTGCCAGCACCGCGACAGGGTTTGGAAACACCATATATTTT	CASTATGFGNTIYF	TRBV9	TRBJ1-3
TGTGCCAGTAGTACATCTGTTTTTGACAGGGCCTACGAGCAGTACTTC	CASSTSVFDRAYEQYF	TRBV19	TRBJ2-7
TGTGCCAGCAGTACAGCAGGCTACACCTTC	CASSTAGYTF	TRBV6-4	TRBJ1-2
TGTGCCAGCAGTGGGACAGGGACCCTCGGCTACACCTTC	CASSGTGTLGYTF	TRBV6-5	TRBJ1-2
TGTGCCAGTAGTATTTCGATGGGGGAGGAGCAGTACTTC	CASSISMGEEQYF	TRBV19	TRBJ2-7
TGTGCCAGCAGTGACTGCCGGGCCCGGGACAACAAAGACACTGAAGCTTTCTTT	CASSDCRARDNKDTEAFF	TRBV6-4	TRBJ1-1
TGTGCCAGCAGGTGGGGACAGATGGCCGGGGAGCTGTTTTTT	CASRWGQMAGELFF	TRBV28	TRBJ2-2
TGTGCCAGCAGCTTAGCAGGGGAAGTAGGCACTGAAGCTTTCTTT	CASSLAGEVGTEAFF	TRBV11-3	TRBJ1-1
TGTGCCACCAGTGATTTGAGGACATCGGGACAGGGTTACGGGGTACTTGAAGCTTTCTTT	CATSDLRTSGQGYGVLEAFF	TRBV24-1	TRBJ1-1
TGTGCCAGCAGTGGGTGCAGGGGGGGGAACACTGAAGCTTTCTTT	CASSGCRGGNTEAFF	TRBV25-1	TRBJ1-1
TGTGCCAGCAGCCGGGAGCCAACCATGATTTTCTCCTACGAGCAGTACTTC	CASSREPTMIFSYEQYF	TRBV7-3	TRBJ2-7
TGTGCCAGCAGCTTAGCCAGCGGGACTAACCACGATACGCAGTATTTT	CASSLASGTNHDTQYF	TRBV7-4	TRBJ2-3
TGTGCCAGCAGTGAAGCGGACAGGGGAAGGAAAGCTTTCTTT	CASSEADRGRKAFF	TRBV6-1	TRBJ1-1
TGTGCCAGTAGTACGCAACACCGTTTCGGCAATGAAAAACTGTTTTTT	CASSTQHRFGNEKLFF	TRBV19	TRBJ1-4
TGCGCCAGCAGGGTGGCGAGCCGGGGGCGGGACAAACAGCCCCAGCATTTT	CASRVASRGRDKQPQHF	TRBV10-1	TRBJ1-5
TGTGCCACCAGCCTGACAACAGATACGCAGTATTTT	CATSLTTDTQYF	TRBV15	TRBJ2-3
TGTGCCAGCAGTTCACTGGGGGGGCGCTGTGAGCAGTTCTTC	CASSSLGGRCEQFF	TRBV12-4	TRBJ2-1
TGTGCCATCAGTTCCGGGGCACCCCTCCACTTT	CAISSGAPLHF	TRBV10-3	TRBJ1-6
TGTGCCAGCAGTGGGCTGTTTGGGGTGAGTGAGCAGTTCTTC	CASSGLFGVSEQFF	TRBV28	TRBJ2-1
TGTGCCAGCAGCCGAACTAGCGGGAGACCGACAGATACGCAGTATTTT	CASSRTSGRPTDTQYF	TRBV11-3	TRBJ2-3
TGTGCCAGCAGCGTAGCAGACTGGGTAGCGTATGAGCAGTTCTTC	CASSVADWVAYEQFF	TRBV9	TRBJ2-1
TGCAGCGGGGACAGTGAGCAGTACTTC	CSGDSEQYF	TRBV29-1	TRBJ2-7
TGCGCCAGCAGCTTGGGGCGCCCAACGGGCAGTGTCGAGCAGTACTTC	CASSLGRPTGSVEQYF	TRBV5-1	TRBJ2-7
TGTGCCAGCAGCGTAGGTTTATATTTCCGTATGCGGGAGATTATTGAAGCTTTCTTT	CASSVGLYFRMREIIEAFF	TRBV9	TRBJ1-1
TGTGCCAGCAGCGTAAATGCCCCCCTAACGGACAGGGTGTCAAATGGCTACACCTTC	CASSVNAPLTDRVSNGYTF	TRBV9	TRBJ1-2
TGTGCCAGCAGCCCGACGTTCTATGGCTACACCTTC	CASSPTFYGYTF	TRBV5-6	TRBJ1-2
TGTGCCAGCAGCCAGGGGAGTACAACTAATGAAAAACTGTTTTTT	CASSQGSTTNEKLFF	TRBV3-1	TRBJ1-4
TGTGCCAGCAGCCAAGCGGATCAGGGGGTCTCTGGGGCCAACGTCCTGACTTTC	CASSQADQGVSGANVLTF	TRBV3-1	TRBJ2-6
TGTGCCAGCAGTTACGGCCCCGGGACAGGGCCCCCCGGGGAGCTGTTTTTT	CASSYGPGTGPPGELFF	TRBV6-2	TRBJ2-2
TGTGCCTGGAGTTTAGGGGGACTAGATACGCAGTATTTT	CAWSLGGLDTQYF	TRBV30	TRBJ2-3
TGTGCCAGCAGTGATAAATCACTAGTCCAACCCTGTAGCAATCAGCCCCAGCATTTT	CASSDKSLVQPCSNQPQHF	TRBV25-1	TRBJ1-5
TGTGCCAGCAGCTTAGCGCGTCAAGGCGGGCCAGAGACCCAGTACTTC	CASSLARQGGPETQYF	TRBV7-2	TRBJ2-5
TGCAGTGCTAGATCTAAATACAAGTTCTATGGCTACACCTTC	CSARSKYKFYGYTF	TRBV20-1	TRBJ1-2
TGTGCTAGCAGCGGAAAGTGGGGGGGGCCTAGCGTGTTTAACATTCAGTACTTC	CASSGKWGGPSVFNIQYF	TRBV7-7	TRBJ2-4
TGCGCCAGCAGCCAAGATAGCTTGGGGGGCACAGATACGCAGTATTTT	CASSQDSLGGTDTQYF	TRBV4-3	TRBJ2-3
TGCAGTGCTAGAGATCTGGCTAGGGCTCTTGGCGGGCATGGAAACACCATATATTTT	CSARDLARALGGHGNTIYF	TRBV20-1	TRBJ1-3
TGTGCTAGTGGTTTGCCTGGGGCAGAGACCCAGTACTTC	CASGLPGAETQYF	TRBV12-5	TRBJ2-5
TGTGCCAGCAGTACTGGCATGATAGGATATGGCTACACCTTC	CASSTGMIGYGYTF	TRBV27	TRBJ1-2
TGTGCCAGCAGCTTAGGTCGCAATGTTTCTGGAAACACCATATATTTT	CASSLGRNVSGNTIYF	TRBV11-2	TRBJ1-3
